########---
#@-----##--
#-$.$.$.-#-
#-.$.-.$.-#
#-$####-$-#
#--#---#.-#
#*$#---#$*#
#--#---#.-#
#-$####-$-#
#-.$.-.$.-#
#-$.$.$.-#-
#------##--
########---
Title: D
Author: laizhufu + Jordi Domenech