###################
####--#######--####
###-$-#######-$-###
##*-*--#####--*-*##
#--*-*-#####-*-*--#
##-*-*--###--*-*-##
##--*-*-###-*-*--##
###-*-*--#--*-*-###
###--*-*-#-*-*--###
####-*-*-#-*-*-####
####--*-*-*-*--####
#####-*-*@*-*-#####
#####--*-*-*--#####
######-*-*-*-######
######--*-*--######
#######-*-*-#######
#######--.--#######
########-.-########
###################
Title: 胜利在望——V
Author: Laizhufu