########-
#@-.-.-##
#-$.$.$-#
#-$###$-#
#--##---#
#.$.-$.#-
#.$.-$.#-
#--##---#
#-$###$-#
#-$.$.$-#
#--.-.-##
########-
Title: B
Author: laizhufu + Jordi Domenech