-######-######-
##----###----##
#-.$$$.-.---.-#
#-..@$.#**$-*-#
#-.$*$.-*-*-*-#
#-.$-..$*-$**-#
##.$$$.$.---.##
-###-$$#$$-###-
##.---.$.$$$.##
#-**$-*$..-$.-#
#-*-*-*-.$*$.-#
#-*-$**#.$-..-#
#-.---.-.$$$.-#
##----###----##
-######-######-
Title: 风车——N
Author: Laizhufu + Werner Ettinger