-------###-----
----####.##----
---##--.-.##---
--##-$-#-$-##--
-##-$--.--$-##-
##.$-$-##$-$-#-
#.@--#$.$----#-
##.#.#.#.#.#.##
-#----$.$#---.#
-#-$-$##-$-$.##
-##-$--.--$-##-
--##-$-#-$-##--
---##.-.--##---
----##.####----
-----###-------
Title: J
Author: laizhufu