#################
#@--------------#
#-*.*.*.*.*.*.*-#
#-.$-$-$-$-$-$.-#
#-*-#$#######-*-#
#-.$#.....--$$.-#
#-*-#.$$$$$-#-*-#
#-.$#.$...$-#$.-#
#-*-#.$.$.$-#-*-#
#-.$#.$$$.$-#$.-#
#-*-#.....$-#-*-#
#-.$#-$$$$$-#$.-#
#-*-$-------#-*-#
#-.$-######$#$.-#
#-*-$-$-$-$-$-*-#
#-.*.*.*.*.*.*.-#
#---------------#
#################
Title: G
Author: laizhufu + Jordi Domenech