----#####-----------
---##---##-#####----
--##--*--###---##---
-##--*-*--#--*--##--
##--*-#-*---*-*--##-
#--*-###-*-*-#-*--##
#-.-##-#-#*#-##-*$@#
#####--#--.--###-$-#
-------#######-#---#
---------------#####
Title: 我心飞翔——M
Author: laizhufu + Jordi Domenech