---########--
-###--#---##-
##...$-....#-
#-.#$$-$.#.##
#-..-$-$-$.-#
#-.$$$*$$$$-#
##---*@*---##
#-$$$$*$$$.-#
#-.$-$-$-..-#
##.#.$-$$#.-#
-#....-$...##
-##---#--###-
--########---
Title: F
Author: laizhufu + Jordi Domenech