--########
-#-------#
#--*****+#
#-*------#
#-*-######
#-*-#-----
#-*-#-----
#-*-######
#-*------#
#--****$-#
-#-------#
--########
Title: C
Author: laizhufu