########------
#------#------
#-.***-#------
#----*-#------
#-****-#------
#-#----#------
#-****-#------
#----*##------
#-****-#------
#-#----#------
#-****-#------
#----*-#------
#-****-#######
#-#----------#
#-*-*#*-*#*#-#
#-*-*-*-*-*--#
#-***-***-*$-#
#-----------@#
##############
Title: L
Author: laizhufu + Jordi Domenech