#################
#-----*-***-----#
#-.$.-*---*-.$.-#
#-$#$-*-***-$#$-#
#-.$.-*-*---.$.-#
#-----*-***-----#
#*****#---#*****#
#*---*-.$.-----*#
#*****-$@$-*****#
#----*-.$.-----*#
#*****#---#*****#
#-----*****-----#
#-.$.-*-----.$.-#
#-$#$-*****-$#$-#
#-.$.-*---*-.$.-#
#-----*****-----#
#################
Title: 时钟——O
Author: Laizhufu