#####-#########-#####
#---###-#-@-#-###---#
#-#...###$$$###...#-#
#-$-.-$-.-$-.-$-.-$-#
#-$$*$$#..*..#$$*$$-#
#-$-.-$-.-$-.-$-.-$-#
###...###$$$###...###
#-#-#-#-#-#-#-#-#-#-#
###$$$###...###$$$###
-#.-$-.-$-.-$-.-$-.#-
##..*..#$$*$$#..*..##
#-.-$-.-$-.-$-.-$-.-#
#-#$$$###...###$$$#-#
#-----#-#---#-#-----#
#####################
Title: I
Author: laizhufu + Jordi Domenech