###----------------
#@-###---###-------
#-*---###-#-###----
#--##$---$-$--##---
-#--#.-*-*-*-*-##--
-##---###*-*-*-$-#-
--#-***.#.-*-*-*-#-
--#-$-----##-*-*-#-
---#-******.#.-*-#-
---#-$--------#--#-
----##-$******..#--
-----#--------##-#-
------###-#-##----#
---------###------#
Title: 一叶知秋——Q
Author: Laizhufu +stopheart + anian