#######
#.-$-.#
#-$@$-#
#.-$-.#
#######
Title:Level_0
Author:测试关卡