-----#######-----
-----#--#--#-----
----#-$-$-$-#----
----#-.-+-.-#----
---#-$-###-$-#---
---#-.##-##.-#---
--##$-#---#-$##--
--#-.#######.-#--
-#-$-$-$-$-$-$-#-
-#-.-.-.-.-.-.-#-
#-$-#########-$-#
#-.-#-------#-.-#
#####-------#####
Title: A
Author: laizhufu + Jordi Domenech