#########################
#################------@#
#################-#.$*$.#
###############--.$*$.--#
#############--.$*$.--###
#############.$*$.---####
#############--.$*$.--###
###############--.$*$.--#
################---.$*$.#
#############---.$**$.--#
##########---.$**$.---###
#######---.$**$.---######
####---.$**$.---#########
#---.$**$.---############
#.$**$.---###############
#------##################
#########################
Title: 闪电——S
Author: Laizhufu