#############
#------#----#
#-$#$-*-#*#-#
#-$.$..-$-$-#
##.*.$.$.*.-#
#--#-$.$-#-##
#--.*-*-*..##
#-.#$-*-$#-@#
##-#-$.$.#.##
#--#-$.$-#--#
#-##-$*$.##-#
#-----#-----#
#############
Title: Y推——Y
Author: Laizhufu + gyjgw