###############
#-------------#
#-**.*.*.*.*.-#
#-.$-$-$-$-$$-#
#-*$########--#
#-.-#------####
#-*$#----------
#-.-##########-
#-*$-$-$-$-$-#-
#-.*.*.*.*.*-#-
#-*$---------#-
#-.-##########-
#-*$#----------
#-.-#----------
#-*$###########
#-.$-$-$-$-$--#
#-**.*.*.*.*+-#
#-------------#
###############
Title: E
Author: 西北天狼