####---####
#.-#---#-.#
#-$#---#$-#
#.-#---#-.#
#-$#---#$-#
#.-#####-.#
#-$*-*-*$-#
#.--*-*--.#
#-$*-*-*$-#
#.--*-*--.#
#-$$-$-$$@#
##-.-.-.-##
-#########-
Title: 半桶水——U
Author: Laizhufu