########--##########-
-#----#----##----##--
-#-$$-#---##--$-##---
-#--$-#--##--$-##----
-#-$$-#-##--$-##-----
-#--$-###--$-##------
-#-$$-##--$-##-------
-#--$-#.-$-##--------
-#-$$-#**.##---------
-#-@*$..*.##---------
-#-$$-#..*.##--------
-#--$-##..*.##-------
-#-$$-###..*.##------
-#--$-#-##..*.##-----
-#-$$-#--##..*.##----
-#--$-#---##..*.##---
-#-$$-#----##..*.##--
-#----#-----##..*.##-
########---##########
Title: Sokoban Revenge #78 Doctor K
Author: Yoshio Sakae